border_size=1
usage=map

Cud         , Cud         , Cud         , Cud         , Cud         , Cud         , Cud         , Cud         , Cud         , Cud         , Cud         , Cud         , Cud         , Cud         , Xu          , Nc          , Nc          , Nc          , Nc          , Nc          , Nc          , Nc          , Nc          , Nc          , Xu          , Cud         , Cud         , Cud         , Cud         , Cud         , Cud         , Cud         , Cud         , Cud         , Cud         , Cud         , Gg          , Xu          , Gg          , Gg          , Gg          , Gg          , Gg          , Gg          , Gg          , Gg          
Cud         , Cud         , Cud         , Cud         , Cud         , Cud         , Cud         , Cud         , Cud         , Cud         , Cud         , Cud         , Cud         , Cud         , Xu          , Nc          , Nc          , Nc          , Nc          , 8 Kud       , Nc          , Nc          , Nc          , Nc          , Xu          , Cud         , Cud         , Cud         , Cud         , Cud         , Cud         , Cud         , Cud         , Cud         , Cud         , Cud         , Xu          , Gg          , Xu          , Gg          , Gg          , Gg          , Gg          , Gg          , Gg          , Gg          
Cud         , Cud         , Cud         , Cud         , Cud         , Cud         , Cud         , Cud         , Cud         , Cud         , Cud         , Cud         , Cud         , Uu^Vu       , Xu          , Nc          , Nc          , Nc          , Nc          , Nc          , Nc          , Nc          , Nc          , Nc          , Xu          , Cud         , Cud         , Cud         , Cud         , Cud         , Cud         , Cud         , Cud         , Cud         , Cud         , Cud         , Xu          , Xu          , Xu          , Gg          , Gg          , Gg          , Gg          , Gg          , Gg          , Gg          
Xu          , Xu          , Xu          , Xu          , Xu          , Xu          , Xu          , Xu          , Xu          , Xu          , Xu          , Xu          , Xu          , Xu          , Xu          , Nc          , Nc          , Nc          , Nc          , Nc          , Nc          , Nc          , Nc          , Nc          , Xu          , Xu          , Xu          , Xu          , Xu          , Xu          , Xu          , Xu          , Xu          , Xu          , Xu          , Xu          , Xu          , Xu          , Xu          , Gg          , Gg          , Gg          , Gg          , Gg          , Gg          , Gg          
Cud         , 6 Kud       , Cud         , Cud         , Cud         , Xu          , Rd          , Rd          , Rd          , Rd          , Rd          , Rd          , Rd          , Rd          , Xu          , Nc          , Xu          , Nc          , Op          , Op          , Op          , Nc          , Xu          , Nc          , Xu          , Rd          , Rd          , Rd          , Rd          , Xu          , Rd          , Rd          , Cud         , Cud         , Cud         , 7 Kud       , Xu          , Xu          , Xu          , Gg          , Gg          , Gg          , Gg          , Gg          , Gg          , Gg          
Cud         , Cud         , Cud         , Cud         , Cud         , Xu          , Rd          , Xu          , Xu          , Xu          , Xu          , Xu          , Xu          , Rd          , Rd          , Xu          , Rd          , Xu          , Op          , Cud         , Op          , Xu          , Rd          , Xu          , Rd          , Rd          , Rd          , Rd          , Rd          , Xu          , Rd          , Rd          , Rd          , Cud         , Cud         , Cud         , Xu          , Xu          , Xu          , Gg          , Gg          , Gg          , Gg          , Gg          , Gg          , Gg          
Cud         , Cud         , Cud         , Cud         , Cud         , Xu          , Rd          , Xu          , Rd          , Rd          , Rd          , Rd          , Rd          , Rd          , Rd          , Rd          , Rd          , Xu          , Op          , Op          , Op          , Xu          , Rd          , Rd          , Rd          , Rd          , Rd          , Rd          , Rd          , Xu          , Rd          , Rd          , Rd          , Cud         , Rd          , Cud         , Xu          , Xu          , Xu          , Gg          , Gg          , Gg          , Gg          , Gg          , Gg          , Gg          
Cud         , Cud         , Cud         , Cud         , Cud         , Xu          , Rd          , Xu          , Xu          , Rd          , Xu          , Rd          , Xu          , Rd          , Xu          , Rd          , Xu          , Xu          , Op          , Op          , Op          , Xu          , Rd          , Rd          , Rd          , Rd          , Rd          , Rd          , Rd          , Xu          , Rd          , Rd          , Rd          , Rd          , Rd          , Rd          , Xu          , Xu          , Xu          , Gg          , Gg          , Gg          , Gg          , Gg          , Gg          , Gg          
Cud         , Cud         , Cud         , Cud         , Cud         , Xu          , Rd          , Xu          , Rd          , Xu          , Rd          , Xu          , Rd          , Xu          , Rd          , Xu          , Rd          , Xu          , Op          , Op          , Op          , Xu          , Rd          , Rd          , Rd          , Rd          , Rd          , Rd          , Rd          , Cud         , Rd          , Rd          , Rd          , Rd          , Rd          , Rd          , Xu          , Xu          , Xu          , Gg          , Gg          , Gg          , Gg          , Gg          , Gg          , Gg          
Xu          , Cud         , Xu          , Xu          , Xu          , Xu          , Xu          , Rd          , Xu          , Rd          , Xu          , Rd          , Xu          , Rd          , Xu          , Rd          , Xu          , Cud         , Op          , Op          , Op          , Cud         , Rd          , Rd          , Rd          , Rd          , Rd          , Rd          , Rd          , Xu          , Rd          , Rd          , Rd          , Rd          , Rd          , Rd          , Xu          , Xu          , Xu          , Gg          , Gg          , Gg          , Gg          , Gg          , Gg          , Gg          
Cud         , Cud         , Cud         , Cud         , Cud         , Xu          , Rd          , Xu          , Rd          , Xu          , Rd          , Xu          , Rd          , Xu          , Rd          , Xu          , Rd          , Xu          , Op          , Op          , Op          , Xu          , Xu          , Rd          , Xu          , Rd          , Xu          , Rd          , Xu          , Xu          , Xu          , Rd          , Xu          , Rd          , Cud         , Rd          , Xu          , Xu          , Xu          , Gg          , Gg          , Gg          , Gg          , Gg          , Gg          , Gg          
Cud         , Cud         , Cud         , Cud         , Cud         , Xu          , Rd          , Rd          , Rd          , Rd          , Rd          , Rd          , Rd          , Rd          , Rd          , Rd          , Rd          , Xu          , Op          , Op          , Op          , Xu          , Rd          , Xu          , Rd          , Xu          , Rd          , Xu          , Rd          , Xu          , Rd          , Xu          , Rd          , Xu          , Rd          , Xu          , Xu          , Xu          , Xu          , Gg          , Gg          , Gg          , Gg          , Gg          , Gg          , Gg          
Cud         , Cud         , Cud         , Cud         , Cud         , Rd          , Rd          , Rd          , Rd          , Rd          , Rd          , Rd          , Rd          , Rd          , Rd          , Rd          , Rd          , Xu          , Op          , Op          , Op          , Xu          , Rd          , Rd          , Rd          , Rd          , Rd          , Xu          , Rd          , Rd          , Rd          , Rd          , Rd          , Rd          , Rd          , Rd          , Xu          , Xu          , Xu          , Gg          , Gg          , Gg          , Gg          , Gg          , Gg          , Gg          
Xu          , Cud         , Xu          , Xu          , Xu          , Xu          , Rd          , Rd          , Rd          , Rd          , Rd          , Rd          , Rd          , Rd          , Rd          , Rd          , Rd          , Cud         , Op          , Op          , Op          , Cud         , Rd          , Rd          , Rd          , Rd          , Rd          , Rd          , Rd          , Rd          , Rd          , Rd          , Rd          , Rd          , Rd          , Rd          , Xu          , Xu          , Xu          , Gg          , Gg          , Gg          , Gg          , Gg          , Gg          , Gg          
Cud         , Cud         , Cud         , Cud         , Cud         , Xu          , Rd          , Rd          , Rd          , Rd          , Rd          , Rd          , Rd          , Rd          , Rd          , Rd          , Rd          , Xu          , Op          , Op          , Op          , Xu          , Rd          , Rd          , Rd          , Rd          , Rd          , Xu          , Rd          , Rd          , Rd          , Rd          , Rd          , Rd          , Rd          , Rd          , Xu          , Xu          , Xu          , Xu          , Gg          , Gg          , Gg          , Gg          , Gg          , Gg          
Cud         , Cud         , Cud         , Cud         , Cud         , Rd          , Rd          , Rd          , Rd          , Rd          , Rd          , Rd          , Rd          , Rd          , Rd          , Rd          , Rd          , Xu          , Op          , Op          , Op          , Xu          , Xu          , Rd          , Xu          , Rd          , Xu          , Xu          , Rd          , Rd          , Rd          , Rd          , Rd          , Rd          , Rd          , Rd          , Xu          , Xu          , Xu          , Xu          , Gg          , Gg          , Gg          , Gg          , Gg          , Gg          
Cud         , Cud         , Cud         , Cud         , Cud         , Xu          , Rd          , Rd          , Rd          , Rd          , Rd          , Rd          , Rd          , Rd          , Rd          , Rd          , Rd          , Xu          , Op          , Op          , Op          , Xu          , Rd          , Xu          , Rd          , Xu          , Rd          , Xu          , Rd          , Rd          , Rd          , Rd          , Rd          , Rd          , Rd          , Rd          , Xu          , Xu          , Xu          , Xu          , Gg          , Gg          , Gg          , Gg          , Gg          , Gg          
Xu          , Cud         , Xu          , Xu          , Xu          , Xu          , Rd          , Rd          , Rd          , Rd          , Rd          , Rd          , Rd          , Rd          , Rd          , Rd          , Rd          , Cud         , Op          , Op          , Op          , Xu          , Rd          , Rd          , Rd          , Rd          , Rd          , Xu          , Rd          , Rd          , Rd          , Rd          , Rd          , Rd          , Rd          , Rd          , Xu          , Xu          , Xu          , Xu          , Gg          , Gg          , Gg          , Gg          , Gg          , Gg          
Cud         , Cud         , Cud         , Cud         , Cud         , Xu          , Rd          , Rd          , Rd          , Rd          , Rd          , Rd          , Rd          , Rd          , Rd          , Rd          , Rd          , Xu          , Op          , Op          , Op          , Xu          , Rd          , Rd          , Rd          , Rd          , Rd          , Rd          , Rd          , Rd          , Rd          , Rd          , Rd          , Rd          , Rd          , Rd          , Rd          , Xu          , Xu          , Xu          , Gg          , Gg          , Gg          , Gg          , Gg          , Gg          
Cud         , Cud         , Cud         , Cud         , Cud         , Xu          , Xu          , Xu          , Xu          , Xu          , Xu          , Xu          , Xu          , Xu          , Xu          , Xu          , Xu          , Xu          , Op          , Op          , Op          , Cud         , Rd          , Rd          , Rd          , Rd          , Rd          , Xu          , Rd          , Rd          , Rd          , Rd          , Rd          , Rd          , Rd          , Rd          , Rd          , Xu          , Xu          , Xu          , Xu          , Gg          , Gg          , Gg          , Gg          , Gg          
Cud         , Cud         , Cud         , Cud         , Cud         , Cud         , Rd          , Rd          , Rd          , Rd          , Rd          , Rd          , Rd          , Xu          , Rd          , Rd          , Rd          , Xu          , Op          , Op          , Op          , Xu          , Xu          , Rd          , Xu          , Rd          , Xu          , Xu          , Xu          , Rd          , Xu          , Rd          , Xu          , Rd          , Xu          , Rd          , Xu          , Xu          , Xu          , Xu          , Xu          , Gg          , Gg          , Gg          , Gg          , Gg          
Xu          , Xu          , Xu          , Xu          , Xu          , Xu          , Xu          , Xu          , Xu          , Rd          , Rd          , Rd          , Rd          , Xu          , Rd          , Rd          , Rd          , Cud         , Op          , Op          , Op          , Xu          , Rd          , Xu          , Rd          , Xu          , Re^Vct      , Xu          , Rd          , Xu          , Rd          , Xu          , Rd          , Xu          , Rd          , Xu          , Cud         , Xu          , Xu          , Xu          , Xu          , Gg          , Gg          , Gg          , Gg          , Gg          
Cud         , Cud         , Cud         , Cud         , Cud         , Cud         , Cud         , Cud         , Cud         , Xu          , Rd          , Rd          , Rd          , Xu          , Rd          , Rd          , Rd          , Xu          , Op          , Op          , Op          , Xu          , Rd          , Rd          , Rd          , Rd          , Rd          , Xu          , Rd          , Rd          , Rd          , Rd          , Rd          , Rd          , Cud         , Cud         , Cud         , 5 Kud       , Xu          , Xu          , Xu          , Xu          , Gg          , Gg          , Gg          , Gg          
Cud         , Cud         , Cud         , Cud         , Cud         , Cud         , Cud         , Cud         , Cud         , Xu          , Rd          , Rd          , Rd          , Xu          , Rd          , Rd          , Rd          , Xu          , Op          , Op          , Op          , Cud         , Rd          , Rd          , Rd          , Rd          , Rd          , Xu          , Rd          , Rd          , Rd          , Rd          , Rd          , Rd          , Cud         , Cud         , Cud         , Cud         , Rd          , Xu          , Xu          , Xu          , Xu          , Gg          , Gg          , Gg          
Cud         , Cud         , Cud         , Cud         , Cud         , Cud         , Cud         , Cud         , Cud         , Xu          , Rd          , Rd          , Rd          , Rd          , Rd          , Rd          , Rd          , Xu          , Op          , Op          , Op          , Xu          , Rd          , Rd          , Rd          , Rd          , Rd          , Xu          , Rd          , Rd          , Rd          , Rd          , Rd          , Rd          , Rd          , Cud         , Cud         , Cud         , Rd          , Rd          , Xu          , Xu          , Xu          , Gg          , Gg          , Gg          
Xu          , Cud         , Cud         , Cud         , Cud         , Cud         , Cud         , Cud         , Cud         , Xu          , Rd          , Rd          , Rd          , Rd          , Rd          , Rd          , Rd          , Xu          , Op          , Op          , Op          , Xu          , Xu          , Rd          , Rd          , Rd          , Rd          , Xu          , Rd          , Rd          , Rd          , Rd          , Rd          , Rd          , Rd          , Rd          , Rd          , Rd          , Rd          , Rd          , Rd          , Xu          , Xu          , Xu          , Gg          , Gg          
Xu          , Xu          , Xu          , Cud         , Cud         , Cud         , Xu          , Xu          , 4 Kud       , Xu          , Xu          , Xu          , Xu          , Xu          , Xu          , Xu          , Xu          , Xu          , Op          , Op          , Op          , Xu          , Xu          , Xu          , Xu          , Xu          , Xu          , Xu          , Xu          , Rd          , Rd          , Rd          , Xu          , Rd          , Xu          , Rd          , Rd          , Rd          , Rd          , Rd          , Xu          , Xu          , Xu          , Xu          , Gg          , Gg          
Xu          , Xu          , Xu          , Cud         , Cud         , Cud         , Xu          , Xu          , Xu          , Xu          , Xu          , Xu          , Xu          , Xu          , Xu          , Xu          , Xu          , Xu          , Op          , Op          , Op          , Xu          , Xu          , Xu          , Xu          , Xu          , Xu          , Xu          , Xu          , Rd          , Cud         , Rd          , Xu          , Xu          , Xu          , Rd          , Cud         , Rd          , Xu          , Xu          , Xu          , Xu          , Xu          , Xu          , Gg          , Gg          
Gg          , Xu          , Gg          , Xu          , Gg          , Xu          , Gg          , Xu          , Gg          , Xu          , Gg          , Xu          , Xu          , Xu          , Gg          , Xu          , Gg          , Xu          , Gg          , Op          , Gg          , Xu          , Gg          , Xu          , Gg          , Xu          , Gg          , Xu          , Gg          , Xu          , Gg          , Xu          , Gg          , Xu          , Gg          , Xu          , Gg          , Xu          , Gg          , Xu          , Gg          , Xu          , Xu          , Xu          , Gg          , Gg          
Gg          , Gg          , Gg          , Gg          , Gg          , Gg          , Gg          , Gg          , Gg          , Gg          , Gg          , Gg          , Gg          , Gg          , Gg          , Gg          , Gg          , Gg          , Gg          , Gg          , Gg          , Gg          , Gg          , Gg          , Gg          , Gg          , Gg          , Gg          , Gg          , Gg          , Gg          , Gg          , Gg          , Gg          , Gg          , Gg          , Gg          , Gg          , Gg          , Gg          , Gg          , Gg          , Gg          , Gg          , Gg          , Gg          
Gg          , Gg          , Gg          , Gg          , Gg          , Gg          , Gg          , Gg          , Gg          , Gg          , Gg          , Gg          , Gg          , Gg          , Gg          , Gg          , Gg          , Gg          , Gg          , Gg          , Gg          , Gg          , Gg          , Gg          , Gg          , Gg          , Gg          , Gg          , Gs^Fp       , Gs^Fp       , Gs^Fp       , Gg          , Gg          , Gg          , Gg          , Gg          , Gg          , Gg          , Gg          , Gg          , Gg          , Gg          , Gg          , Gg          , Ha          , Gg          
Gg          , Gg          , Gg          , Gg          , Gg          , Gg          , Gg          , Gg          , Gg          , Gg          , Gg          , Gg          , Gg          , Gg          , Gg          , Gg          , Gg          , Gg          , Gg          , Gg          , Gg          , Gg          , Gg          , Gg          , Gg          , Gg          , Gg          , Gs^Fp       , Hh^Fp       , Hh^Fp       , Hh^Fp       , Gs^Fp       , Gg          , Gg          , Gg          , Gg          , Gg          , Gg          , Gg          , Gg          , Ha          , Gg          , Gg          , Gg          , Ha          , Ha          
Gg          , Gg          , Gg          , Gg          , Gg          , Gg          , Gg          , Gg          , Gg          , Gg          , Gs^Fp       , Gg          , Gs^Fp       , Gs^Fp       , Gs^Fp       , Gg          , Hh          , Hh          , Hh^Fp       , Gg          , Gg          , Gg          , Gg          , Gg          , Gg          , Gg          , Gg          , Gs^Fp       , Hh^Fp       , Hh^Fp       , Hh^Fp       , Gg          , Gg          , Gg          , Gg          , Gg          , Gg          , Gg          , Gg          , Gg          , Ha          , Ha          , Ha          , Ha          , Ms          , Ms          
Gg          , 1 Gg        , 2 Gg        , 3 Gg        , Gg          , Gg          , Gg          , Gg          , Gs^Fp       , Gs^Fp       , Gs^Fp       , Gs^Fp       , Gg          , Gg          , Gs^Fp       , Gs^Fp       , Hh^Fp       , Hh^Fp       , Hh^Fp       , Gs^Fp       , Gs^Fp       , Gg          , Hh          , Gg          , Gg          , Gg          , Hh^Fp       , Hh^Fp       , Hh^Fp       , Hh          , Hh^Fp       , Hh          , Hh^Fp       , Gg          , Gg          , Gg          , Gg          , Gg          , Gg          , Gg          , Ha          , Ha          , Ms          , Ms          , Ms^Vhha     , Ms          
Gg          , Gg          , Gg          , Gg          , Gg          , Gg          , Gg          , Gs^Fp       , Gs^Fp       , Gs^Fp       , Gg          , Gs^Fp       , Gg          , Gg          , Gg          , Hh^Fp       , Hh^Fp       , Hh^Fp       , Hh^Fp       , Gs^Fp       , Gs^Fp       , Hh^Fp       , Hh^Fp       , Hh^Fp       , Gg          , Hh^Fp       , Hh^Fp       , Hh          , Hh^Fp       , Hh^Fp       , Hh^Fp       , Hh^Fp       , Hh^Fp       , Hh^Fp       , Gg          , Gg          , Ha          , Ha          , Ha          , Ha          , Ms          , Ms          , Ms          , Ms          , Ms          , Ms          
