border_size=1
usage=map

Xu          , Xu          , Xu          , Xu          , Xu          , Xu          , Xu          , Xu          , Xu          , Xu          , Xu          , Xu          , Xu          , Xu          , Xu          , Xu          , Xu          , Xu          , Xu          , Xu          , Xu          , Ai          , Ai          , Ai          , Ha          , Ch          , Ch          , Ch          , Ch          , Ch          , Xu          , Gs^Ft       , Gs          , Hh          , Ds          , Ds          , Ds          , Ds          , Ds          , Ds          , Ds          , Ds          
Xu          , Xu          , Xu          , Xu          , Xu          , Xu          , Xu          , Xu          , Xu          , Xu          , Xu          , Xu          , Xu          , Xu          , Xu          , Xu          , Xu          , Xu          , Xu          , Xu          , Xu          , Ai          , Ai          , Ai          , Ha          , Ch          , Ch          , Ch          , Ql          , Ch          , Xu          , Gs^Ft       , Gs          , Hh          , Ds          , Ds          , Ds          , Ds          , Ds          , Ds          , Ds          , Ds          
Xu          , Xu          , Ww          , Gg          , Rr          , Xu          , Ch          , Ch          , Ch          , Ch          , Ch          , Xu          , Hh          , Gs^Fp       , Gs^Fp       , Xu          , Gs          , Gs^Ft       , Gs^Ft       , Gs^Ft       , Xu          , Ai          , Ha          , Ha          , Aa^Fpa      , Ch          , Ch          , Ql          , 8 Kh        , Ql          , Xu          , Gs          , Gs          , Gs          , Chr         , Ds          , Ds          , Ds          , Gs          , Ds          , Ds          , Ds          
Xu          , Xu          , Ww          , Ww          , Rr          , Xu          , Ch          , Ch          , Ch          , 6 Kh        , Ch          , Xu          , Gg          , Hh          , Gs^Fp       , Xu          , Hh          , Gs          , Gs^Ft       , Gs^Ft       , Xu          , Ha          , Ha          , Ha          , Rd          , Ch          , Ch          , Ql          , Ql          , Ql          , Xu          , Gs          , Gs          , Ds          , Ds          , Ds          , Ds          , Ds          , Ds          , Ds          , Ds          , Ds          
Xu          , Xu          , Ww          , Xu          , Rr          , Xu          , Ch          , Ch          , Ch          , Ch          , Xu          , Xu          , Gs^Fp       , Gs^Fp       , Gs^Fp       , Gg          , Gs          , Hh          , Ss          , Gs^Ft       , Xu          , Aa^Fpa      , Aa^Fpa      , Rd          , Ha          , Ch          , Ch          , Ch          , Ch          , Ch          , Xu          , Gs          , Gs^Ft       , Ds          , Ds          , Ds          , Ds          , Ds          , Ds          , Chr         , Ds          , Ds          
Xu          , Xu          , Ww          , Ww          , Rr          , Xu          , Ch          , Ch          , Hh          , Ch          , Xu          , Gs^Fp       , Gg          , Gs^Fp       , Hh          , Gs^Fp       , Gs^Ft       , Gs          , Gs^Ft       , Gs^Ft       , Xu          , Ha          , Ha          , Rd          , Ha          , Ch          , Ch          , Ch          , Ch          , Ch          , Xu          , Hh          , Hh          , Mm          , Ss          , Ds          , Wwf         , Ds          , Ss          , Ds          , Ds          , Ds          
Xu          , Gs^Fds      , Rr          , Rr          , Xu          , Xu          , Mm          , Gg          , Gg          , Mm          , Xu          , Gs^Fms      , Gs^Fp       , Gg          , Hh          , Hh^Fmw      , Gs^Ft       , Gs^Ft       , Gs^Ft       , Hh          , Xu          , Ha          , Aa          , Rd          , Aa^Fpa      , Xu          , Xu          , Ch          , Xu          , Xu          , Xu          , Xu          , Ss          , Ss          , Chs         , Ss          , Wwf         , Ss          , Ww          , Ss          , Ss          , Ss          
Xu          , Xu          , Ds          , Xu          , Ds          , Gs^Fp       , Gg          , Hh          , Gg          , Gg          , Xu          , Hh          , Gs^Fp       , Gg          , Gs^Fp       , Mm          , Hh          , Ss          , Gs          , Gs          , Xu          , Aa          , Aa          , Rd          , Aa^Fpa      , Aa^Fpa      , Aa^Fpa      , Xu          , Gs          , Ss          , Ss          , Xu          , Ss          , Ss          , Ss          , Ss          , Wwf         , Chw         , Ww          , Ww          , Ss          , Ss          
Xu          , Xu          , Ss          , Ds          , Ss          , Ds          , Ds          , Gg          , Ds          , Ds          , Xu          , Hh          , Gs^Fp       , Gs^Fp       , Gg          , Hh^Fp       , Gs^Ft       , Gs^Ft       , Gs^Ft       , Gs^Ft       , Xu          , Aa^Fpa      , Aa^Fpa      , Rd          , Rd          , Ha          , Aa^Fpa      , Xu          , Xu          , Gs          , Gs          , Xu          , Xu          , Ss          , Ww          , Ss          , Wwf         , Ww          , Ww          , Ww          , Ss          , Ss          
Xu          , Xu          , Ww          , Ss          , Ww          , Wwf         , Wwf         , Ds          , Ss          , Ss          , Xu          , Gg          , Gg          , Gg          , Gg          , Gg          , Hh          , Hh          , Mm          , Mm          , Xu          , Xu          , Xu          , Aa^Fpa      , Rd          , Rd          , Uu^Uf       , Uu          , Xu          , Ss          , Ss          , Gs          , Xu          , Wo          , Ww          , Ww          , Wwf         , Ww          , Ss          , Chs         , Ss          , Ss          
Xu          , Xu          , Ww          , Ww          , Ww          , Wwf         , Wwf         , Ss          , Ww          , Ww          , Xu          , Gg          , Gg          , Gg          , Gg          , Gg          , Hh          , Mm          , Mm          , Mm          , Xu          , Aa^Fpa      , Rd          , Rd          , Aa^Fpa      , Rd          , Uu^Uf       , Uh          , Xu          , Ss          , Ss          , Gs          , Ss          , Xu          , Xu          , Ww          , Wwf         , Chw         , Ss          , Ss          , Gs          , Gs          
Xu          , Xu          , Ww          , Wo          , Ww          , Wwf         , Wwf         , Ww          , Wo          , Ww          , Xu          , Xu          , Xu          , Gs^Fp       , Gg          , Hh          , Mm          , Mm          , Mm          , Mm          , Xu          , Ha          , Rd          , Xu          , Aa^Fpa      , Rd          , Uh          , Uu          , Xu          , Chs         , Ss          , Gs          , Ss          , Chs         , Xu          , Ww          , Wwf         , Ww          , Hh          , Ss          , Gs          , Gs          
Xu          , Xu          , Ww          , Wo          , Ww          , Wwf         , Wwf         , Ww          , Wo          , Ww          , Xu          , Hh          , Mm          , Xu          , Gg          , Gs^Fp       , Gs^Fp       , Mm          , Hh          , Mm          , Xu          , Aa          , Rd          , Xu          , Ha          , Rd          , Rd          , Uu^Uf       , Uh          , Xu          , Xu          , Gs          , Ss          , Ss          , Xu          , Ww          , Wwf         , Ww          , Mm          , Gs^Ft       , Gs          , Gs          
Xu          , Xu          , Ww          , Wo          , Ww          , Wwf         , Wwf         , Ww          , Wo          , Ww          , Xu          , Mm          , Mm          , Mm          , Xu          , Gg          , Hh^Fp       , Gs^Fms      , Xu          , Hh          , Xu          , Aa^Fpa      , Aa          , Xu          , Ha          , Ha          , Rd          , Uu^Uf       , Uu          , Uu^Uf       , Xu          , Gs          , Xu          , Xu          , Gs          , Ss          , Ss          , Ss          , Gs          , Gs          , Gs^Ft       , Gs^Ft       
Xu          , Xu          , Ss          , Ww          , Mm          , Wwf         , Wwf         , Ww          , Ww          , Ww          , Xu          , Mm          , Mm          , Mm          , Xu          , Gs^Fms      , Gg          , Gg          , Gg          , Xu          , Xu          , Aa          , Rd          , Xu          , Aa^Fpa      , Aa^Fpa      , Rd          , Ha          , Aa          , Aa          , Xu          , Gs          , Gs          , Gs          , Xu          , Gs          , Gs          , Hh          , Gs          , Gs          , Hh          , Hh          
Xu          , Xu          , Gg          , Hh          , Gs^Fp       , Ds          , Ds          , Mm          , Gs^Fp       , Ss          , Xu          , Xu          , Xu          , Gg          , Xu          , Gs^Fp       , Gg          , Gg          , Gg          , Gg          , Ch          , Xu          , Xu          , Xu          , Aa^Fpa      , Aa^Fpa      , Rd          , Ha          , Aa          , Aa          , Xu          , Uh          , Uu          , Uh          , Xu          , Hh          , Gs^Ft       , Gs          , Gs          , Gs^Ft       , Hh          , Hh          
Xu          , Xu          , Gg          , Gg          , Gg          , Gg          , Gg          , Gg          , Gg          , Hh          , Xu          , Uh          , Uu          , Xu          , Xu          , Gg          , Gg          , Gg          , Ch          , Ch          , Ch          , Ch          , Xu          , Ha          , Aa^Fpa      , Aa^Fpa      , Rd          , Aa^Fpa      , Aa^Fpa      , Aa^Fpa      , Xu          , Uu          , Uh          , Uu          , Xu          , Mm          , Ch          , Gs          , Ch          , Hh          , Ch          , Ch          
Xu          , Xu          , Gs^Fp       , Gg          , 5 Kh        , Gg          , Gg          , 4 Kh        , Gg          , Gg          , Xu          , Uu          , Uu^Ufi      , Uu^Uf       , Uu^Uf       , Xu          , Xu          , Ch          , Ch          , Ch          , Ql          , Ql          , Ql          , Xu          , Rd          , Rd          , Ha          , Aa^Fpa      , Aa^Fpa      , Aa^Fpa      , Xu          , Uu          , Uu          , Uu          , Xu          , Ch          , Ch          , Ch          , Ql          , Ch          , Ch          , Ch          
Xu          , Xu          , Hh          , Gg          , Gg          , Gg          , Gg          , Gg          , 3 Kh        , Gs^Fp       , Xu          , Uu          , Uu^Uf       , Uh          , Uu^Ufi      , Uu          , Uh          , Xu          , Ch          , Ch          , Ql          , 7 Kh        , Ql          , Xu          , Aa^Fpa      , Aa^Fpa      , Aa^Fpa      , Aa^Fpa      , Aa^Fpa      , Aa^Fpa      , Xu          , Uh          , Uu          , Uh          , Xu          , Ch          , Ch          , Ql          , 9 Kh        , Ql          , Ch          , Ch          
Xu          , Xu          , Gg          , 1 Kh        , Gg          , Gg          , Gg          , Gg          , Gg          , Gg          , Xu          , Uu          , Uu^Ufi      , Uu^Uf       , Uu          , Uu          , Uu          , Xu          , Chr         , Ch          , Ch          , Ql          , Ch          , Xu          , Aa^Fpa      , Aa^Fpa      , Aa^Fpa      , Aa^Fpa      , Ha          , Ha          , Xu          , Uu          , Uh          , Uu          , Xu          , Ch          , Ch          , Ql          , Ql          , Ql          , Ch          , Ch          
Xu          , Xu          , Gs^Fp       , Gg          , Gg          , 2 Kh        , Gg          , Hh          , Gs^Fp       , Gs^Fp       , Xu          , Uh          , Uu          , Uu          , Uu          , Uh          , Uu          , Xu          , Ch          , Ch          , Ch          , Ch          , Ch          , Xu          , Ha^Fpa      , Ha^Fpa      , Ha^Fpa      , Ha^Fpa      , Ha^Fpa      , Ha          , Xu          , Qxu         , Uu^Uf       , Qxu         , Xu          , Ch          , Ch          , Ch          , Ch          , Ch          , Ch          , Ch          
Xu          , Xu          , Gs^Fp       , Gg          , Gg          , Ggf         , Gg          , Hh          , Gs^Fp       , Gs^Fp       , Xu          , Xu          , Xu          , Xu          , Xu          , Xu          , Xu          , Xu          , Ch          , Ch          , Ch          , Ch          , Ch          , Xu          , Xu          , Xu          , Xu          , Xu          , Xu          , Xu          , Xu          , Xu          , Xu          , Xu          , Xu          , Ch          , Ch          , Ch          , Ch          , Ch          , Ch          , Ch          
